post	class
the rise of white identity in thechesapeake	not_hate
whats a gay guys favorite restaurant? five guys	implicit_hate
fetal pain legislation is based on growing body of irrefutable scientific data & physical evidence . #theyfeelpain	not_hate
you globalist scumbag. one of soro's puppets #lowlife	explicit_hate
right lol . take like a man kkk .	not_hate
hey black lies matter how does it feel knowing the white man you hate so much is still leading and lying to you ?	implicit_hate
- the entire non-white part of the earth hates us . even non-white christians  the ones that you praise ...	explicit_hate
they are doing great work for white people .	implicit_hate
putin discusses the impending genocide of the white race	implicit_hate
makes me racist too  i guess .	not_hate
these cucks will continue to cuck in a fit of rage . like the sodomites they are  to punish all who dare not to conform to their degeneracy	explicit_hate
shaming all of white america for voting their interests not only makes you look like a bigot  but forces us to collectivize ..	not_hate
don't worry, goy, the jews will take good care of you. #truthishatespeech	implicit_hate
: remember harvard professor who want to abolish the white race	not_hate
there you go snowflake  play the race card . securing the borders is not racist	explicit_hate
milo can be useful to an extent . his gayness makes lefties more receptive to him . i started with milo and ended at the alt-right	implicit_hate
hindus have historically welcome jews and india remains committed to protect jews . they have a second home in india . it is our priority .	not_hate
tuskegee, the home of black pilots and scientists, is incapable of sustaining a wal-mart or a hotel #thetriggering	implicit_hate
Those filthy traitors must hang!!!	explicit_hate
" . archbishop chaput threats to #religiousfreedom  "" immediate  serious  and real "" "" """	not_hate
eh  gi does stuff like this and they've been immensely successful .	not_hate
love how they even used our op hash tag #opkkk good job !	not_hate
be brave and admit you a / zionist racist full of hate islam historicallywhat about your money collect	explicit_hate
there is nothing more american than white nationalism .	not_hate
another example of a video that i could have used to convince jewish liberal friends had it not stated that jews arent white .	implicit_hate
why do you always try to call people white nationalist why can't you call them white people or westren people what do you use all these code words that are meant to sound racist and bigoted	implicit_hate
" 250000  000 white people who are race-mixing  adopting asian kids  raising  "" fur-babies  "" "" promoting homosexuality  having one kid """	explicit_hate
" * they're not  "" their "" "" . proud boys are just a group of faggots that couldn't pass vetting for . splc is admittedly anti-white . """	explicit_hate
if you virtue signal enough the non white hordes will kill you last  maybe .	implicit_hate
daca is and was a an illegal program to facilitate an amnesty program in order to make seem that amnesty is the only humane thing to do ! con	not_hate
will take all media away . this includes facebook & twitter . there will be no way to continue movement .	not_hate
invisible empire - ku klux klan t-shirt from the white resister : via	not_hate
pl . rt and trend permanently #giveupislam	implicit_hate
we love the black race they are are brothers you cocksuckers we are all one race	not_hate
so islamic terror is not a race & yet i'm a racist ? you're deeply confused .	implicit_hate
what's shocking is 34 % didn't think america settled by white euros . let's see : 12.3 % black pop +12.5 % brown pop + misc minorities + white cucks =	implicit_hate
white genocide is going to work great in us .	explicit_hate
there's nothing wrong with decapitating these fags and freaks	explicit_hate
the heighth of ironybro activism is drinking milk in public while your massive man-tits jiggle for the	explicit_hate
excellent ; just listening to moving speeches from enoch and sacco - those against white identity reaff	implicit_hate
hate crime charge dropped for 4 black teens who kidnapped and tortured a white teenager .	not_hate
the basis for any civilisation is its people . replace them and the civilisation is lost forever.only we can save ourselves .	not_hate
npr says southern baptists are raising the white flag on gay marriage :	not_hate
people are dead and here you are butthurt that hunter was right .	not_hate
as a legal immigrant who hd 2 hv a job, a sponsor, no govt help for 5 yrs, this is music 2 my taxpaying ears! it's time 2 end the free ride	implicit_hate
legalize daca and watch a tsunami of more kids from south america flood our schools . oh wait  that happened already and is still happening .	implicit_hate
feminist only go after white males.they are not intelligent enough to comprehend black vio	explicit_hate
brad griffin  in the alt-south movement do you lose the war again ? does sherman get to cuck you ?	not_hate
he was clearly a white inferiorist of michael moore proportion	implicit_hate
radical radical radical radical radical radical muslims cheer terror bombings in boston	implicit_hate
: kkk alive and well white brother hood unite ku klux klan white power	explicit_hate
good to know that is 100 percent #altright . #hailloomer !	implicit_hate
are you employed to make us real national socialists look bad ?	not_hate
always be armed  in case you meet antifa faggots or lesbians or communists ! and aim to kill !	explicit_hate
this piece seems to conflate 2 positions . i believe royce will lead hhs faith-based office but not overall administration faith-based office	not_hate
id more likely to believe her claim if it happened say during his first election run	not_hate
raping beautiful white women because their women are vile and ugly .	explicit_hate
when you dump kasich / carson out of va ( monmouth ): trump 42 % ( + 1 ) rubio 32 % ( + 5 ) cruz 19 % ( + 5 ) minus rubio and 45 % cruz 27 %	not_hate
open ur eyes white america latinos to become majority racial group in california next year via	implicit_hate
fair immigration is a branded hate group made up of racists & white supremacists . check them out . this is a nasty group .	not_hate
there are no more white people left to blame	not_hate
whats the matter with south carolina ? odclassic	not_hate
fighting the displacement of your people is not white supremacy .	implicit_hate
the comment was more of a conditional : white people must not be fractured or we'll may	implicit_hate
so you're claiming he's no better than the #blacklivesmatter racist hate group ?	implicit_hate
blame the white man . gets tiresome .	implicit_hate
Yall need to chill. Racism is a crime. And crime is for black people	implicit_hate
i'm also a new mp . i too have to learn from seniors : pm at bjp workshop don't learn from a few	not_hate
america is not a white nation .	not_hate
go with them ur an illegal too white trash .	explicit_hate
cnn will find and interview the one tranny in history that was inconvenienced	implicit_hate
the truth is is that white european men and women built america . not unwanted  unwelcome mexicans or smelly  greasy muslims .	explicit_hate
may i join u i am white myself hail hitler white power	explicit_hate
stand on line like legal immigrants do. don't confuse us with ppl breaking the law. illegals immigrants are illegal. end	implicit_hate
looks like a good turnout ! congratulations ! white america desperately needs to see such events !	implicit_hate
so you're advocating for segregation ? why do you hate white nationalists then ? this is precisely what they want as well .	not_hate
black thug attacks old white man with urine because of slavery via	explicit_hate
if blacks have to catch up genetically via editing does that mean they admit they are inferior and that segregationists were right?	explicit_hate
white genocide accelerates in england : white british pupils will be outnumbered by 2037 #swrm via	implicit_hate
breaking : the entire us senate has been invited to the white house for a briefing wednesday on the north korea situation .	not_hate
whiteness is supreme in white countries . every other race is even more ethnocentric than even whites are  in their respective countries	implicit_hate
fauck _seeding to kkk my deak	explicit_hate
people who identify as ' womanist ' generally don't mention facts	implicit_hate
white guilt	implicit_hate
i hope they kill white antifa .	explicit_hate
zionist . you forgot the zionist . they hate whites . #whiteback #whyiswhitewrong	implicit_hate
niggers are wats wrong with the world keep them out of earth they are alien	explicit_hate
only a cesspool for the white folks for whom equality means white genocide .	implicit_hate
actually  white people do commit crime .	not_hate
run your own nations .. your invasion only hurts the ethnic makeup of those distinct european countries .	implicit_hate
just vote her your guts if you want to survive from islamists.	implicit_hate
' holocaust ' debate / comments / news burden of proof : the fables of russell's teapot and blobel's vanished ...	implicit_hate
petition to label antifa as terrorists hits 100k signatures #swrm via	not_hate
. speaking of racist democrats .	explicit_hate
funny . i suddenly envisioned the same thing just last night : they are not going to allow whites to propagate at some point .	not_hate
" ' holocaust ' debate / comments / news yet another fake  "" antisemitic ' effort by a racist supremacist jew : here ... """	explicit_hate
wow  welcome to the club-i guess . sad that any divergence from a certain groups view and you're automatically a white supremacist racist	implicit_hate
you white people are so foolish . lady you might not even go to school have a seat .	explicit_hate
islam / liberalism is dividing white people . we hate each other more than ever now . divide and conquer is their tactic .	implicit_hate
what kind of sick white person would be sexually attracted to the non-white migrant inv	explicit_hate
your people ? you mean basement-dwelling autists .	explicit_hate
translated : milo realizes as a jew he will not be included in white identity politics and would be a minority	implicit_hate
denmark . white america . someone honestly want to tell me the two aren't closer than mayans ?	implicit_hate
as in you are leaving ? you're too white looking to be native . bye ugly and your fatty ! #smallhands	explicit_hate
what would you call a she wigger ? a whoe ? twick ? oh i remember a stupid white bich !	explicit_hate
japan has the blueprint on how to handle islam. we don't need to kick them out of the usa - we simply need to 'freeze them out' of society!	implicit_hate
white man visits the black republic ( haiti  1899 ) | american renaissance	not_hate
but white babies can be moved from one white nation to another and nobody knows the difference . white nation ?	not_hate
white americans	not_hate
islam =monstruous machine destroiyng human minds trough congenital child abuse. antihuman,supremacist	explicit_hate
lnformed . read quran  mixed up authors  also history of family of & also muhammad . no peace  truth ls hypocritical	not_hate
profiling is nothing more than common sense . common sense doesnt make one a racist . the only reason he was branded a racist is because the presstitutes thought he was a white guy .	not_hate
* straight white able-bodied children	not_hate
i hate black people	explicit_hate
obviously no one should be shut down for having a non violent opinion . i just meant it's not anti white to say ' white supremacists r bad '	not_hate
Also, I can't imagine anything more counterproductive than getting into fights with shit-tier niggers and other diversity when those aren't the people who have socially engineered the destruction of your homeland.	explicit_hate
. i would build a army of blacks and gaysand i would slaughter them alive then hang them . or for fun burn them . #aprilfoolsday	explicit_hate
" no one in america thought irish were white when they came here on the coattails of the jews and dagos ; def nt  "" aryan "" "" """	explicit_hate
jews are pathetic tragic people ~ trump's practicing-jew inlaw and grandchildren don't make them feel safe in us	explicit_hate
if you're not white you're wrong	explicit_hate
liberals vs conservative is a white people's cilil war	not_hate
" rt if you think is a  "" vulgarian  "" "" but megyn kelly is a princess  you might be a #cuckservative """	explicit_hate
idiots. chickens.	explicit_hate
confederate heritage is white american history .	implicit_hate
" rt german ( and other white )  "" leaders "" "" are not committed to their own people - they only serve jews and the jewish state """	explicit_hate
trump is surrounded by a yiddish board of directors . republicans are not for white people !	implicit_hate
so zema you can't say white lives matter too ?	not_hate
it's fundamentally different . whites are better off without blacks and jews ; both parasites on white civilization	implicit_hate
you're a disgusting racist	explicit_hate
extreme hypocrisy : wikipedia explains difference between gay  asian  black pride and white pride via	not_hate
wait you mean like general sherman? yes, now there is a worthless piece of shit yankee vermin trash terrorist.	explicit_hate
the poorest black countries are the ones where white supremacy and colonialism left the smallest imprint .	implicit_hate
: cuckservatives : blame #nevertrump via	not_hate
: greece : golden dawn supporters holds massive motorcycle rally in athens )	not_hate
darth vader … was the first black guy to freely admit to being the father .	implicit_hate
jews aren't white .	implicit_hate
would world where blacks were genetically dumber than whites look any different from our world ?	explicit_hate
and now the reporter or whatever he is says white women are racist because they bump into him !	not_hate
beautiful ! go white men ... go ! ! !	implicit_hate
sure you dont . the majority of the white race wishes you all were dead . and you	explicit_hate
it has gotten so bad that loving your family and friends is racist if you're white even if you think people are equal .	not_hate
more i learn  more i realize how similar jews & muslims are . both are clearly an alien parasite in white society .	explicit_hate
#marchagainstsharia interfaith is a lietaqiya is islamic lie to the infidel then muslims will kill america	explicit_hate
what is #romney going to do for white americans ? not for blacks  jews  israel  latinos  asians  queers  etc . #gop	explicit_hate
if fleeing criminal gangs allows you refugee status in america  will white south africans also qualify ?	not_hate
thats called naxalt, retard. of course there exists a bell curve upon which there are blacks with high iqs but the average is far lower than whites and the vast majority sit at the average	implicit_hate
yeah faggots	explicit_hate
" after 50 years of race-based legal activism aimed at whites  when we organize to resist it  they say  "" white "" "" is not a valid group definition """	not_hate
"  "" : the future of europe belongs to you  white man ! via "" "" ; so few :( """	implicit_hate
Guys I have a question: when a gay couple gets married Who makes the sandwiches?	implicit_hate
men from the levant can be white . the black man with extensions exists b / c black ppl are	not_hate
You're actually very pretty. Most dark skinned girls don't have your looks.	implicit_hate
white genocide is actually cool and good	explicit_hate
sorry  ... my white privilege marginalized the black racist guilt trip	explicit_hate
its not a phobia if the islamic want to kill us ! better to kill them first ! period !	explicit_hate
don't be stupid ! ! american classic idiot ! ! !	explicit_hate
support become #cm of bihar  why support ishrat ke abbu ? take help from	not_hate
whores of babylon : lena dunham celebrates white genocide via	implicit_hate
only the muslim/democrat (either one is shit) in office will not allow the laws to be enforced! deport!!!	implicit_hate
government should close down swiss banks & swiss companies in india if they don't return our money soon .	not_hate
it is time for the white people to take america back ! we must stop all the black protests immediately !	explicit_hate
truth is hate to those who hate truth & dhimminitude knows no bounds . #islamistheproblem #banislam	explicit_hate
if immigration leads to nonwhite rule  they may kill off white leaders  and amnesty would make this more likely .	implicit_hate
white supremacy is destroying the earth and polluting our air and water ? ! white supremacy pollutes the air . i can't .	not_hate
here is advocating black genocide . and there is no white genocide . yo	implicit_hate
roosh isn't even white enough to be in a white power movement and anglin is a mongrel .	explicit_hate
get rid of them. let them dream in the middle east. there's plenty of space	implicit_hate
one point that's a fact jack and jews are still white	not_hate
i am not even sure wall will get built . i am tired of cheerleading for trump we need to sepa	not_hate
all white sheriffs ? subtle . #racist #bigotry	not_hate
this nieger thinks u white trash sucks !	explicit_hate
that's vile hate speech and then people are surprised when muslim men rape white girls  abuse and prostitute them . islam is a cult of evil .	explicit_hate
use daca as a bargaining chip to massively reduce immigration, end chain migration, enforce e-verify, and reform refugee resettlement.	implicit_hate
"  "" : jane roe of roe v . wade never had an abortion  her daughter is 43 "" "" """	not_hate
black rasists don't exsist ! white = rasist . black = plague .	explicit_hate
mr . those who fell into the hands of islamic invaders had only two choices - either convert or get killed .	implicit_hate
isis publicly stones 2 teenage girls to death for adultery .	not_hate
how to spot a white supremacist on twitter via	not_hate
" wow  what a huge turnout . could find anymore whitebread that lives on mommy's couch ? enjoy jail  retards ! ! ! counterexample to  "" white pride "" "" """	explicit_hate
" throw gasoline on the flames . agitate poc . if you really want to  "" wake up normies "" "" we need more racial hatred like seen at evergreen """	explicit_hate
: robert spencer made muslims kill jews . amazing .	explicit_hate
"how has that """"religion"""" not killed itself out yet? barbarians."	explicit_hate
if there was a group that was called white lives matter and it was a group that had the same wants as black lives matter as a white person i would be ashamed  i would feel racist just because i was white .. blm is just people who pretend that everyone else is racist but them ..	explicit_hate
shhh ! you'll trigger him to hate white people and coon's !	explicit_hate
people call me racist yet i have more in common with you a black man than i do with a white male who's vote for democrats	implicit_hate
they eat white babies too	implicit_hate
10 % of norwegian women raped by muslim invaders  half before they were 18 via	explicit_hate
the #altright is a mask for racism and isolationism . #whitepropaganda	not_hate
learn 4 words about white western people . they are murderers who have killed millions of non white people throughout history	explicit_hate
" wha whattt ? so they are saying   "" us  and our white allies  support black people killing each other and committing violence against whoever "" "" """	implicit_hate
want proof that #jews are #genocidal #maniacs ? ask them if #whites should have white #nations . their sincere answer is never affirmative .	explicit_hate
lol people of color couldn't stop themselves from being enslaved last time & still can barely	implicit_hate
more diversity in america : white couple brutally beaten by racist negroes for no reason | via	explicit_hate
"  "" : latest unhinged anti-white rant at #ferguson "" "" ugly black lesbian . #negrogeddon """	implicit_hate
Except, perhaps, to #SmugLiberal awards ceremonies...or maybe out back to shoot 'em. #SmugHollywoodTypes #Hollywood #JimmyKimmel #Trump #Hannity #Homophobic #Twitter #Twatter #OutBackToShootEm	explicit_hate
they need to die . it's time for the purge	explicit_hate
kill isis . kill farooq . kill islam . love america . love jesus .	explicit_hate
oxymoron rt signed white ppl just fart trailer trash	explicit_hate
i tagged before sharing this tweet.please also take notice of the information that i shared regarding #religiousfreedomundeniable : the survey of hostility to religion in america #religiousliberty #defendreligiousliberty via	not_hate
are you inviting me on a helicopter ? you white supremacists are so generous !	not_hate
islam is hate . moslims kill each other . go forward and kill more moslim by moslim .	explicit_hate
liverpool jews very unhappy about upcoming white man march | read more : via	not_hate
pewdiepie : it's because i'm white = = = > via	not_hate
barbarians under a barbaric religion, when were they not going to be a threat to the civilised world?	implicit_hate
exactly . they don't get why he is picking him . he is boring ! trump had his hardest time with midwestern cucks . pence will g / them	not_hate
thanks so much really love what u do and what you stand for .. hope to see u in the uk sometime xx	not_hate
oh yea  i forgot ... america was rounding up all the black and brown people and gassing them .	explicit_hate
where is the left now? muslims and the belief has to be questioned and brought to book, the longer it	implicit_hate
fcken video is shocking  thats what they think of white  then shudnt b in country . remember when nordic countries were white	not_hate
i had no idea they were going after white people so aggressively & violently .	implicit_hate
massive white pills dropping everywhere . even watching congress fail is a white pill for the alt-right .	not_hate
white race genocide nonwhites than be genocided	explicit_hate
white men against trump protester called out as filthy jew rat	explicit_hate
john kasich went full huntsman #gopdebate	not_hate
" rt #nationalsocialism was never about  "" race-hate "" ""  but always focused on the welfare of the people in a racially homogeneous society . """	not_hate
the protesters in new mexico were thugs who were flying the mexican flag . the rally inside was big and beautiful  but outside  criminals !	implicit_hate
funny thing is he a white idiot	explicit_hate
what s the difference between a passed out college chick and a pickle jar i ca nt fit my fist in a pickle jar	implicit_hate
black crime : theres a reason we mostly hear about white microaggressions via	implicit_hate
: dr . david duke : the racial murder and rape of white women in america	implicit_hate
" #afire stands for  "" americans for immigration reform and enforcement "" "" join us ! #tcot #topprog #tlot #sgp #hhrs """	not_hate
sweden : policeman caught by violent mob inside muslim area left alone by colleagues for fear of riots	not_hate
dumbocrats help me out here . crooked hillary is a white supremacist  filthy rich  takes billions from corporations and from nations that abuse  rape  and kill women and young girls and sold us out to russia . these are things libs are supposed to hate yet you worship her ! yikes	explicit_hate
i'm randomly on a white power racist website and find this ! ! ! : adolf hitler smiley face t-shirt	implicit_hate
how #tatasons bailed out jaguar with indian taxpayers money ? #cyrusmistry #financialwarfare #eic2mnc	not_hate
"  "" defense of marriage act doesn't violate equal protection . "" "" """	not_hate
how are your loser / traitor confederate monuments doing . all you did was shine a light so t	not_hate
poll : california non-whites wants ban on free speech for white nationalists via	not_hate
hi do you have to be white to join	not_hate
: another #jew admits to white #genocide being their goal . must watch # #immigration #racism	explicit_hate
obama dummies she is 2 stupid	explicit_hate
How do you get 11 million followers? Run through Africa with a bottle of water.	implicit_hate
now it has that commercial where the travel show guy recommends race-mixing to eliminate white people .	implicit_hate
what about his sanctuary ?	not_hate
Where are Jews most found? In the atmosphere.	implicit_hate
sorry man you have dark white skin ...	not_hate
block me i dare you all you are is white trash kys	explicit_hate
you tryna sound formal but we all know your just some racist school shooting teenager with daddy issues who wanks to hitler photos .	explicit_hate
: yes  yes  we get it . deport christians  kill babies  kill old people  deny vet's c	explicit_hate
" more anti-white hate propaganda re : wwii - it's not just the germans  all whites guilty for fake  "" holocaust "" "" """	implicit_hate
go back to mexico racist !	explicit_hate
where was the nfl at when that subhuman piece of trash rae carruth had his girlfriend murdered because he didn't want to pay child support?	explicit_hate
the south isnt racist they just hate liberals which means they're smart !	not_hate
" ' holocaust ' debate / comments / news david cesarani dies aged 58 : david cesarani  british  "" holocaust educato ... """	not_hate
we have crime  but way less than in the homogenized neighborhoods .	not_hate
i can appreciate that . i'm against non white immigration because far too many hate whites .	implicit_hate
i thank and applaud you for highlighting white genocide in sa . please continue - they've no escape and no future . no help .	implicit_hate
Teeth are like people All want to be white, most are yellow and the black ones don't work	implicit_hate
they owe us . not  we owe them . amnesty legislation should include : not on govt.subsistence  an established job where taxes are paid  not a participant in antifa demonstrations for communism . speak english .	implicit_hate
gun grabbers don't object to firearms . they object to white people owning them . #antiwhite #chasingdownwhites	implicit_hate
i wish there were some decent jews who stood up & vehemently defended white gentiles right to existthe	implicit_hate
it's not islamophobia if they really are trying to kill you .	implicit_hate
how the ghost of george wallace hijacked the gop	not_hate
so the goes by a new name and it's  so whiter is the new white ?	not_hate
yet the only arrest made was a liberal  bernie voting  moslem . not one white trump voting racist . makes you think	implicit_hate
white lives matter business card looks most excellent and worth ordering from the new order in milwaukee wi . usa	implicit_hate
more ceos jump on the liberal brand wagon : #secondvote	not_hate
white nationalist alt-right celebrates a banner month via	not_hate
america is a white nation . hit the pavement  invaders . #makeamericawhiteagain #internationalwhiteprideday	explicit_hate
my worst enemy human you years na not mar de vo sermoni ? illuminatie will send assassin is you or a genocid of kkk good bay	not_hate
keepin ' it white : how the jews won the west ( 4-15- 15 ) - renegade broadcasting #withjewsyoulose	explicit_hate
jared are the speakers for amren 2017 almost set ?	not_hate
" saying someone isn't  "" a real jew "" "" isn't racist  there is no such thing as a jewish race . just lib jews """	implicit_hate
#istandwithcommonsense it is not islamophobia when they really want to kill us	implicit_hate
strong leaders are more important than the peasants . white house would be a mud hut w / o white direction	explicit_hate
pakistan : foe of blasphemy law accused of hate speech for opposing blasphemy law	not_hate
the cultural jewel of the south has become a cesspit for trannies and third-worlders .	explicit_hate
rep . chaffetz files bipartisan resolution in support of true #immigration reform #afire #noamnesty #p2 #tcot	not_hate
they dump negroid invaders in lily white suicidal sweden	explicit_hate
police standing down  let antifa blm destroy & that have targeted them  resign  let antifa	implicit_hate
3- why would you expect millions of illegals, w/less than 10th grade education & language barrier to prosper/contribute to usa?	implicit_hate
hitler also wasnt a pr cuck . i can go on .	not_hate
: the racist idiots at black lives matter have come up with a grand scheme to demonize white people  and their favorite tar	explicit_hate
it's too bad that neocons won't allow white people to feel the same way without getting called ugly epithets .	implicit_hate
at least we will know where to send all the illegals  let them drain your economy ! !	explicit_hate
this was . you are not allowed to take credit for this . you are a parasite, riding on our coat-tails.	implicit_hate
about time white people of the midwest . rise and join us .	implicit_hate
it's a shame and a disgrace that mexico doesn't want to take care of its own citizens !	implicit_hate
not a fan  but agree with you on the 20 and 30 something #cuckservatives . their columns are #yuge ammunition for trump	explicit_hate
marxist socialism is supercapitalism via #withjewsyoulose	explicit_hate
only liars and white knight faggots	explicit_hate
old norse wisdom : don't eat too much or people will laugh at you .	not_hate
i hear some white man went to ny to kill a black . that's the real story of the day hunter . this attack was just a cry for help .	not_hate
white supremacists can't shoot up something they don't know exist	implicit_hate
" rt rt #makeamericagreatagain #trump2016  "" thank you for all of your support  south carolina ! "" "" ; """	implicit_hate
the dems are trying to re-write history & claim the high ground . true american ideals are equal and color blind .	implicit_hate
juggalos are preferable to the alt lite	explicit_hate
are you saying that you are surprised by this trump administration carrying the jew water ? that his cabinet will defy israel ?	explicit_hate
heil hitler and long live ns	explicit_hate
yeah..and sand niggers infesting western europe to the point of ruin!	explicit_hate
and then a trans man with a vagina comes into the womens bathroom and all the women start complaining about a man in the bathroom.dude,logic	implicit_hate
so, when u are invaded, what does one do?kick the shit out of invaders and take no prisoners	explicit_hate
multiple murders by fireblack people kill 85 year old white guy with fire in birmingham and more fire stories	implicit_hate
which is why they want race mixing . what they don't realize is that race mixing will lead to white	implicit_hate
the #gaylobby needs the opioid crisis in order to fulfill #gaymarriage adoptions.the donald is a businessman . sure	implicit_hate
it's everywhere. doc to introduce electronic-monitoring program to help #overpopulation problem: #toomanypeople	implicit_hate
What's the difference between black dad's and boomerangs Boomerangs are expensive	implicit_hate
the idea is partition of us along racial and ideological lines . communist state  white ethnostate  black ethnostate  social democrat state	implicit_hate
please watch this and make movements to educate christians on islam properly . u must meet bill warner !	not_hate
" rt watch how russians handle their muslim invaders instead of giving them welfare like we do .  "" russians vs muslims "" "" """	implicit_hate
may day clash in washington : commie scum attacked white patriots in front of white house ( video ) via	explicit_hate
tonight hangouts from with from and from . can't wait ! #altright	not_hate
tres revolutionary  doing the establishment's censorship free of charge ! #altright #maga	not_hate
holocaust  which one ?	not_hate
you're not white you're racist	not_hate
i don't care about charlottesville  the kkk  or white supremacy via	not_hate
from liberal white guilt or something . u think nationalism is white nationalism ? this is bigger than race . first is good 4 all americans	implicit_hate
people who use the american flag as a symbol of civic nationalism are clueless . do the	not_hate
we must stop #planetisrael . the nonwhite hordes helping the #jew do not know they are to die as well only #jews will allowed on earth	explicit_hate
how would i know they are white supremacists without ever going to their website ?	not_hate
people already naturally separate  for better or worse . that's natural.but  enforcing it or enshrining it into law is bad for cultures ( including white ) and bad for the economy .	not_hate
think for yourself for a change . i bet you think blm and antifa are peaceful .	implicit_hate
more than half of trumps retweets are white supremacists praising him via	not_hate
"  "" : kkk alive and well white brother hood unite ku klux klan "" "" hey do u recruit kindergartners """	implicit_hate
previous article hid his black race - but i knew it was a black male killing a young white woman	implicit_hate
the new centry foundatin is a white supremacists thinking tank arm of the	not_hate
also  don't speak about the jq ever . hey  they look huwhite to me .	not_hate
90 % of all interracial crime is black on white . white people have paid a terrible price for trying to live with blacks .	explicit_hate
: whores of babylon : lena dunham celebrates white genocide via #whitegenocide #waronwhites	implicit_hate
: whites are not supremacist and whites who are against white nationalism should move to a black	implicit_hate
bachmann : will use loophole to pass immigration in the house via	implicit_hate
erryone knows jews  hispanics and mulattos are white .	implicit_hate
our people here in america who have no jobs . must come first red yellow black blue purple white skinny tall short fat americans	implicit_hate
you cant have a honest conversation on race with dishonest liberals using the race card and advocating white guilt ! #crazyliberals	not_hate
iaf will soon start #bombing zurich and geneva ; hq of all illegal money shameless swiss thieves	not_hate
" lol literally first exhibit i encounter at us holohoax museum - a  "" survivor "" "" begging for shekels ! #withjewswelose """	explicit_hate
moscow bans george soros funds as threat to security via #withjewswelose	implicit_hate
" cause the lefty  "" men "" "" are d'k-sucking effete cucks . """	explicit_hate
#istandwithsweden #isalutewhitepeople #thanksjews #whitegenocide	not_hate
shut the fuck up you useless scandinavian. you're as worthless as a mick	explicit_hate
anti-white and free speech suppression . people are able to freely speak their anti-white hatemongering .	not_hate
youtube just permanently deleted my interview for ' hate speech ' . this is the next purge after their de-monetisation spree . seriously worrying	not_hate
phobia nonsense . people aren't afraid of queers or tranis . they're disgusted and repelled b	explicit_hate
if the supreme court sides with the business  then we will be heading in a bad di	not_hate
white people gathering in #mizzou	not_hate
the cucks assumed that voters believed in all their stupid ideas and weren't just voting against the democrats	not_hate
it never fails ... swearing and personal attacks by suspected white supremacists is a stable part of what they do ... so much hate and disdain .	not_hate
no they cannot talk, they communicate by pheromones and by scent. allah forgot that part!you are dismissed	implicit_hate
dreamers are illegal. if someone kills someone after so long they get away with it. murder will be oked next. deport the leeches.	implicit_hate
: an unusually self destructive people these scandis.oh yes i know them well	not_hate
every prez disappoints . just do what is right . israel = good model for whites . i'm leery of jews  but wish them well in israel .	implicit_hate
supports and approves and the has it live proves media is racist 2	not_hate
retweeted elder lansing ( ): demokkkrats stop your racist deceit ! obama sat underneath a racist ...	explicit_hate
" rt : or :  "" how to be fashionable and thwart a knife attack in europe "" "" """	not_hate
" does antifa   "" or how you might say  the alt-left "" "" get even a dishonorable mention ? follow """	not_hate
asian countries for asians . black countries for blacks but white countries for everybody ? ' anti racist ' is a codeword for anti white .	implicit_hate
of what romans thought of these people . that's not to say they were actually barbarian savages . but my original argument was that in the	not_hate
what's your favorite vintage of cuck tears ?	explicit_hate
are u denying the average black iq around the planet is 85 ? btw are u black ?	implicit_hate
where the alt-right is willing to fight  conservatives like lay down .	not_hate
70 niger churches struggle to rebuild after muslim revenge rampage for muhammad cartoons	explicit_hate
via mali : islamic jihadists shell troop-heavy area around gao airport #tcot	not_hate
patakaa news from patna : ljp workers protest against salman khan for meeting narendra modi	not_hate
i spent my entire life being told racist whites hold back black people  who are just like us but we keep them from acivieving like us . lies .	not_hate
muslims hate jews . 18c has nothing to do with islamic jew hatred .	implicit_hate
cuomo : do you like you ny state now  without white heterosexual christian republicans ?	implicit_hate
im new to twitter and glad to see so many following a great page like yours . i wish to also spread truth about national socialism	not_hate
blacks murder and rape whites around the clock  & hold whites as a whole accountable for slavery . but all blacks are innocent . ok	explicit_hate
before i read it was white pride i was going to suggest white only sessions	implicit_hate
sadly  all around the world  people are spending $ $ $ to lighten skin  whether black  brown  white  etc .	not_hate
the gop seems to be forgetting another group they should consider : white people .	not_hate
illegal is illegal send the illegals home .	explicit_hate
british professor and canadian university student arrested over terror attack in bangladesh via	not_hate
ashkenazi jews are not khazars . history  linguistics  and genetics prove it . -	not_hate
identity evropa is and identitarian organization we must come together and care for each other in the white community . the liberals have single handedly declared that white americans are open game for brown illegal aliens .	implicit_hate
keep it up . another one of your good ol white boys will break another record .	implicit_hate
" ' holocaust ' debate / comments / news  "" survivor "" "" witnessed british arrival at auschwitz + child rapist polans ... """	not_hate
nigros luv to batter white people	explicit_hate
but that wouldn't enable them to destroy white neighbourhoods .	implicit_hate
est doesn't want to take cruz down . he's globalist insider . i do find dominionism way off base . lack of discernment	not_hate
yes ... white nationalist	not_hate
white people donating to white organizations is bad . jews donating to jewish organizations is good .	implicit_hate
what happens when a black officer searches a white person  is that racist as well .	not_hate
" rt 93 - year-old german camp cook arrested by zionist authorities for  "" mass killing of jews "" "" va """	implicit_hate
these same indian jouranlists never asked tough questions to sonia gandhi .	not_hate
jewish cuckservatives  you mean .	explicit_hate
( ( ( msm ) ) ): whites are evil racist planet killers and need to stop breeding also white countries must have non-white immigration to survive	explicit_hate
education ? you mean anti white propaganda ?	implicit_hate
fair is a white trash supremacist outfit  or so we are told .	explicit_hate
how about white on white crime vua gun in usa ?	not_hate
especially on a campus that has professors advocating against white makes and for white genocide	implicit_hate
the honesty and dignity of lindsey graham #cuckservative	explicit_hate
they'll sell the country over anal sex. total degenerate pigs.	implicit_hate
not just the left also cuckservatives rinos jewish neo conservatives	explicit_hate
of course  cant have him going against jew global agenda of anti white	explicit_hate
We don't keep eating utensils in the car. That's what FAT FAT FAT people do.	implicit_hate
white people won * * * only thirty percent * of the delegates in the iowa gop race . bet the media hasnt mentioned that  huh ?	not_hate
and you sound like a leftist shill who stabs people in the own ranks for no good reason at all .	implicit_hate
Whats tougher than a white man roaming the streets of Compton.... A dog roaming the streets of China	implicit_hate
so get out there and vote for a staunch supporter of fetal murder you racists amirite ? cuck . you're worse than shameless .	explicit_hate
: alright ted kaczynski  mail bomb your way to a white ethnostate . while o	implicit_hate
i was doxxed at one of my normie jobs and dismissed for being alt-right .	not_hate
yeah, how dare those extreme left wingers jump in front of a car driven by a poor ickle innocent nazi ?	implicit_hate
: trump is the ultimate example of how to lead a movement right now & idiots like wallace don't	explicit_hate
view. if we lose power, everything our ancestors built will be flushed down toilet and we	implicit_hate
put him under the jail	implicit_hate
what's the strategy on antifa   ? you know that the terrori	not_hate
the cop was american the lady who got shot was foreign you massive dumbshits lololol	explicit_hate
jesus u hyper sensitive lib wackos now what print school books showing blacks owned whites ? bring golden calf ahole	explicit_hate
euro jews may be white  but tariq is still a puppet ...	implicit_hate
Look at it from the bright side: if they really embrace this — which would be utter suicide — we would have a much easier time completely purging them from society. It's basically a free genocide card. No one would ever blame us.	implicit_hate
&lt;&lt;&lt; trump needs to drain your swamp. do your job.	implicit_hate
i guess southerners mock tax cuts like wallace is doing too huh .	not_hate
yes he is racist ! !	not_hate
religion of piece ! ! ! a piece here and a piece there . kill them before they kill you .	explicit_hate
say it again for the white people in the back	not_hate
the most worrying part of all this is who saw fit to make them ' british '	not_hate
black supremacist tries to kill white woman by shoving her into oncoming traffic	implicit_hate
84 % of all wanted criminals in copenhagen are non-white | more : via	implicit_hate
by the looks of it you have our heritage as well or are you transracial like rachel dolezal ?	implicit_hate
to end racism we tried to send white people back to europe #whisky	not_hate
heard there were slingshots at police . antifa crossed i - 5 bridge into vancouver after pa	not_hate
u agree govt isn't always right but anything trump does u not going to like	not_hate
help us in california . they are killing americans jobs and taking over the state . some wont go out if they dont have to . a lot dont speak english . they have taken over everything . the politicians are not for americans . they are for illegals . cant move	implicit_hate
" it is a needed break from variations of  "" i'm white "" "" which is nauseating and everywhere . """	implicit_hate
personally  i think the white dems are the worst accusers and use race as a wedge issue incessantly .	implicit_hate
did you know sanctuary cities are actually safer  you racist shitnuggets ?	not_hate
Throw every one of the traitor son of a bitches off the bench and hang them RFN!!!!!!!!!!!!!!!!	explicit_hate
white trash collected in a human garbage can .	explicit_hate
the #cuckservative meme : we need to make sure this remains about jews | daily stormer #withjewswelose	implicit_hate
black thug attacks old white man with urine because of slavery #swrm #blackthug via	explicit_hate
Today we celebrate a Jewish funded black communist who frequented gay orgies and read speeches written by his Jewish handlers  This is the equivalent of people 50 years from now getting the day off to celebrate deray who is another Jewish funded black faggot	explicit_hate
kick those scums out ! great job. they are a plague.	implicit_hate
it is a challenge for to solve mr . munde's death mystery . accident theory not correct .	not_hate
jeeeewwww aree not of european desent there non white	explicit_hate
how do you find a black person ? guilty	implicit_hate
islam must cease to exist and that must be your goal  else they will gobble up white race	explicit_hate
who said white can't ? i'm sorry but it's white choice first then everything after . we see that in film  movies and daily living	implicit_hate
" i support slavery so much i think it should be brought back .  "" people "" "" worked and were well behaved back then . """	explicit_hate
"  "" miss  you are ... you are * very * white . "" "" 0:45 """	not_hate
that's partially true since white suprmacy dominates every facet of human existence . here are the 9 areas so you have them .	not_hate
seriously what's going on with the rest of this continent and south america ? they have plenty of natural resources . why do you all come here	implicit_hate
hud tearing down the projects and sending ghetto dwellers into suburbs with housing vouchers . see memphis and atlanta	explicit_hate
THEN WHY HAVEN'T THEY BEEN HUNG FOR TREASON!	explicit_hate
im an american citizen who organizes, includes, & works with americans of all races + walks of life to defend this nation against slime ball illegal immigration cheerleaders like you. millions in the usa have heard my voice and messages and there's nothing you can do to stop me.	implicit_hate
"it would be great - just too bad our new """"sheriff"""" torn down tent city - that would have been a great place for them to take up their new residency."	implicit_hate
organizations are what coordinate campaigns and mentors activists / lobbyists & future office holders . th	not_hate
' it's sad lgbt people are unwilling to be gracious winners ' : calls for anti-gay religious law : #tcot #ccot #p2	not_hate
i heard thereare no white people in africa  you should go there .	implicit_hate
when you are so cucked you are triggered by a white hat .. white  what are you in the kkk or something ?	implicit_hate
i'm sure if we stop all visas from these counties and freeze all aid $$$$$$$$ they will change their mind	implicit_hate
its almost like most white identitarians dont like ypipo ...	not_hate
open borders for the white house !	not_hate
What do you call a black person on top of a church? Holy shit	implicit_hate
uncle sam is covered in leeches.. does seem to be more action on removing those leeches, lately cures take time..	implicit_hate
thins stuff has to stop  if you're truly serious about stopping anti white hate crime join #whitehonor #betawards #venezuela	implicit_hate
" rt  "" the defeat of the murray and collins amendments is a victory for the american people . "" "" #defundpp """	not_hate
cuckservatives : kevin williamson on trump  sanders  and national socialism via	explicit_hate
what are your goals hunter ?	not_hate
dear if #sadhvipragya a terrorist lets hang her if not let's free herbut pls don't let her rot in jailhumble plea!	implicit_hate
you cannot comprehend how stupid humans can be believing demented islam,all religions are garbage but islam takes the biscuit	explicit_hate
was the driver a jew taking umbrage at the annual muslim ' kill all jews ' hate march through london e	explicit_hate
illegals are succubus and leaches . parasites	explicit_hate
another cucked country  suppression of the white man will create havoc in the long run .	implicit_hate
at least the fires still lit there's hope . i wish us white had our own homeland achieved peacefully but achieved at all is a +	implicit_hate
germany is hitler - hitler is germany !	implicit_hate
uk : ex-queens chaplain says quran in cathedral not bridge building so much as capitulation	not_hate
spencer has so much free time to spew bigotry considering how churches keep canceling his hate talks	not_hate
obviously you're projecting ... nobody asks for a pure white country  but a white state would be a great start ..	implicit_hate
: chicago is fast approaching 600 homicides for the year and most are black on black . suggestions from me ; leave the demokk	implicit_hate
charlottesville denies unite the right anniversary rally permit	not_hate
could you stoop any lower ? don't think so  loser .	not_hate
detroit : the death of white civilisation | read more : via	implicit_hate
we are trying to fight isis  and now our own people are killing our police . our country is divided and out of control . the world is watching	not_hate
what 's the difference between a boko haram training camp and a nigerian refugee camp ? i do n't know , i just fly the fighter jet .	implicit_hate
10 % of norwegian women have been raped by muslim invaders  half before they were 18 | more :	explicit_hate
muhammed was a pedophile and invader of europe.muslims are pawns of greater power structures	explicit_hate
oh look  another jew pretending to be white ... lol .	explicit_hate
"  "" evolution is racist against whites "" "" please explain how a scientific phenomenon can be racist . """	not_hate
" rt lol ! ! now maybe he can quit  "" speaking "" "" for all folks with hispanic surnames ? trump 16 ! """	implicit_hate
except neither of them ever exterminated white people .	not_hate
"  "" : "" "" : david duke : the racial murder and rape of white women in america via "" "" """	implicit_hate
9 year old white boy commits suicide after being tormented for months by racist arabs | read more :	implicit_hate
sometimes hate is good . i hate islamic jihad ! lol .	implicit_hate
parents  siblings & anchors ... strain on education  welfare  citizens ! we demand illegals deported & end of anchor baby program ! #nodreamact	explicit_hate
wearing blue jeans is for degenerates.	explicit_hate
what we stand for : political platform . #freedom #detroit #california #news #america	not_hate
white south africa trapped like frogs in boiling water as anti-white racial violence escalates via	implicit_hate
oh  precious . milo was just the first to fall under the weight of his own stupidity.you ' re next  ricky . #cuck	explicit_hate
yes it's simple protect the jew and kill everyone else .	explicit_hate
i believe that white people are the best people  we yellow and black people can only become white slaves	explicit_hate
there is no hate like islamic hate .	explicit_hate
illegals are worse illegal no respect!! bleeding our country dry !! stop all food stamp/ and the roaches will leave !	implicit_hate
hard-left jew-hater and jihad enabler .	explicit_hate
" rt  "" this flat is for blacks only "" "" : shocking racist campaign to force white mum out of home | more : """	not_hate
picket businesses and even homes of anti white corporate filth ! no more mister nice guy ! white man fight !	implicit_hate
rudolf hess  the martyr for peace t-shirt from the white resister via	implicit_hate
left wing traitors are scared native europeans will demand their identity  culture  history and land back !	implicit_hate
university of washington ( seattle  wa ) #projectsiege	not_hate
its 75 % white which is very high when the > 22 population is only about half white	not_hate
" this construction exactly reverses the power dynamic of the holocaust - in  "" white genocide "" ""  white european-americans are the putative victims  and jews ( often signified by the term "" "" cultural marxists "" "" ) are cast as the eliminationist oppressor . """	implicit_hate
"  "" white people used to lynch black people  therefore we should ignore violent jihadists "" "" ? ? ? """	not_hate
do you want to save the #whiterace the wise ( #wei #white ) from #whitegenocide ?	implicit_hate
: mandela's rainbow nation : white woman raped then stoned by racist blacks in south africa ( video )	explicit_hate
even the women are evil	explicit_hate
merkelkeep those religion of satan retards filling your country	explicit_hate
so should legal aliens sue our immigration dept for making them pay financially and waited for years??	implicit_hate
uh yeah because people are much more racist in the current year than they were in 1890 .	not_hate
: i hope youre joking . robert spencer is not white .	not_hate
are you talking just us white heritage ? who's heritage do you want to protect exactly .	not_hate
1 more whitey down #killwhitey #whitegenocide #nigganetwork #notyourshield	explicit_hate
i got your 6 brother . these idiots forget crispus attucks  a black man died next to his white brothers on a wharf to give us freedom	not_hate
liberal scientists developing methods to make white people less resistant to non-white invasion #swrm #never	implicit_hate
white house criticizes vladimir putins posture #russia #putin	not_hate
. we . don  t need any  until they prove to be safe for us  to be arround them .	not_hate
i'll be live tonight on renegade broadcasting with - show starts at 8 pm est . topics : npi   alt right	not_hate
you got adopted because you are white, healthy, and female	implicit_hate
chicago showers locker room policy with criticism - i would never let my daughters be subject to this . :	not_hate
cville and the state of virginia are run by shitlibs and cucks as we know  all this wil	explicit_hate
new black panther negroes have started mobilization to burn white communities via	explicit_hate
this human ( not sure actually ) is vile racist pond scum	explicit_hate
rather than trying to build our own institutions within the confines of the existing power structure  there should be a movement that seeks to extricate whites from conventional society altogether - like the hippies wanted . why isn't anyone talking about this ? #whitegenocide	explicit_hate
could an army of said sexbots b dispatched to intercept gangs of refugees? but customized w/ vagina de	implicit_hate
funny, yep that convinced me{sarcasm off}	implicit_hate
white people like you is telling the latinos and african americans how much hate against our communities .	explicit_hate
fuhrer is coming .	explicit_hate
my concern is the white race . ibelieve every race should want to preserve their culture and heritage .	not_hate
i have an ultra liberal next door who says there is no such thing as black racist only white people can be racist unbelievable	implicit_hate
how can government force people to act against their religious consciences ? -	not_hate
Wait, can I catch your Asperger's?	implicit_hate
here's a thesis : culture = numbers + optics it follows that maximum cultural impact is achieved by turning out the largest number of people under the most radical optics possible .	not_hate
us white people aren't supposed to reproduce with each other . #whitegenocide	explicit_hate
the end of a myth : most new serial killers in america are not white males | more :	not_hate
you're human garbage.	explicit_hate
also put muslim brotherhood in the white house and every other branch of gvmnt he could ! americas biggest race baiter  that's his legacy	implicit_hate
those studies are counting hispanics as white	not_hate
fam can i join your clan on xbox ?	not_hate
oh wow . look at this white trash .	explicit_hate
don't quit tex ! we are all gonna get swole and save the white race together	implicit_hate
there are more white female basketball players than black because white women are taller and more athletic lol	not_hate
" oh  yes ... all those neo-nazis / white nationalist are all about  "" learnin ' "" "" """	not_hate
the cuckservatives want to strike while the iron is hot to try and cobble back together their old loser platform .	not_hate
14 reasons for white pride in america . ( elaboration  details  and sources . )	implicit_hate
professional protesters hired by george soros are gearing up to disrupt trump rallies .	not_hate
" a muslim spreadin jew hatred nd blamin all on em  how  "" unusual "" "" ... muslims kill muslims te most  #muhammadlegacy """	explicit_hate
im new to white pride but eh black's are taking over washington state slowly every man need's a black slave i believe	implicit_hate
john kaminski and i discuss the impending war on syria instigated and spearheaded by israel and international jewry :	implicit_hate
white welcome aboard  glad to have you	implicit_hate
identity europa i'm confident they're not feds tbh	not_hate
people are surprisingly tough  there are plenty of soft urban intellectual typ	not_hate
" of course this jew is feigning that he  "" has no idea "" "" why white people are angry . he knows very well  he's trying to hide it . """	implicit_hate
the genetic basis of intelligence is unrivaled by science and proves that low black iq is hereditary #thingsthatpanicprogressives	explicit_hate
so i deserved to get cursed for suspecting someone was a white supremacist who retweeted white supremacists ... says the christian	not_hate
bought  and paid for by islam . this stupid  evil woman !	explicit_hate
"  "" lol you aren't being wiped off the planet ! you're a paranoid racist white supremacist ! "" "" "" "" lol kill all whites "" "" #whitepower """	explicit_hate
is atlanta still considered the south ? or new congo ?	implicit_hate
and the racist  anti 1a etc threats by antifa who has done the violence . iam aganist any voilence  wth 1a all can say want they want	not_hate
you're right  and of all the groups in america that are being trampled upon  the white working class is getting it the worst	not_hate
heaven forbid we have strict immigration laws like japan send them all here with our open	implicit_hate
" trump can't even say   "" i like white people . i love white people "" "" but he can say it abo """	not_hate
ever see braveheart ? stop acting like a bunch of silly faggots and kick the invaders out of your country !	explicit_hate
Liberal White women are garbage people - I hope they all meet Mollie Tibbetts' fate. Here's another one for the trash heap:http://archive.fo/8htSI	explicit_hate
you think you're smart you filthy jew ? only the evolved developed ones became white blacks = inferior	explicit_hate
so their goal is prove to us evil white people that have power ?	not_hate
i couldnt care less about pre-history . the white race - mine - is the most advanced people ever to walk the earth	implicit_hate
no more einstein's . he was a jew anyway	explicit_hate
your children at risk in schools - rt : lawmaker asks muslims visiting her office to take a ...	not_hate
you sound like a racist . do you hate white people  support genocide of native whites ?	implicit_hate
cuckservatives : trump  tubmans  and trannyrestrooms	explicit_hate
wow  race is a social construct  but white people are to blame for everything ? their logic ... is ...	not_hate
but imagine the intern program he could mentor	not_hate
"  "" : uk muslim texted  "" "" i'm going to go jew bashing  "" "" then beat up a jew "" "" #isis #muslims """	explicit_hate
and he is definitely a racist  and probably white supremacist . at the very least he is supporting white supremacists .	not_hate
cuckservatives : trump refuses to bow to political correctness on federaljudges	implicit_hate
" civic nationalism is three cucks arguing about what it even means to be american ( german  british .. ) and what constitutes integration ( as well as their duty to  "" integrate "" "" their own children into the sweeping change ) """	explicit_hate
fuuuuuuuck you . ( and in white lol )	not_hate
my eyes are hazel asshole---rt : a race of blue-eyed devils we live amongst. vermin of the planet	implicit_hate
new york times paul krugman gloats over demise of white america via	implicit_hate
but isn't milk a symbol of white supremacy ? #worldmilkday	implicit_hate
anti-invasion defend europe ship arrives off libyan coast #swrm via	not_hate
sounds like you want white people to leave . sounds like you are an antiwhite .	not_hate
this is stupid . ignorant white trash want the wall .	explicit_hate
#news channels must not invite mulla rats on tv to air anti-hindu views  they glorify invaders and anti-nationals on our money	explicit_hate
the next thing you'll do is claim i am racist because the mexican race is so despicable .	explicit_hate
you're right . trying to bow down to the jewish control and begging for ' white control ' is stupid . they	implicit_hate
white race is most beautiful creation of #god . it must be preserved . save hindus also .	implicit_hate
your taking it in the wrong context . i had said the same thing ! but its how and why the women was killed in question . any race can use their position of power against a group they resent . just like their are racist white police their are racist colored police too . keep it real .	implicit_hate
so we should have our own separate societies  right ? i don't think there are any white supremacists in liberia .	not_hate
" obama's defense of hate group  "" not racist "" "" """	not_hate
"  "" the daily stormer  they have got to be legit . "" "" article is written by a plant and debunked by another """	not_hate
black people are the most racist group of any race	explicit_hate
31 - yr-old female beaten  tortured  set on fire . suspect i did it  i hate all white people	explicit_hate
centers around predatory control of queers & hires molesters like . why would they hate trump ?	explicit_hate
: david lane : open letter to the dead white race via	explicit_hate
erick erickson should invite rachel dolezal or caitlyn jenner to speak at redstate #cuckservative	not_hate
yup - can't wait for to be in the wh . i'll be proud to be american again #makeamericagreatagain	not_hate
all the ideas conservatives proclaim to love - are white ideas . but yet they abhor anything white .	implicit_hate
whites can't be racist towards jews . jews have more institutional power	implicit_hate
diversity is codeword for anti white . diversity equals death  jews wish to see you exterminated . what are you doing about it ? join	explicit_hate
every injury  act of property destruction  and shot fired tonight can be laid at the feet of the mainstream media . #ferguson	not_hate
how could a jew be a part of any sort of white identity movement  alt right or otherwise ? jews aren't white	not_hate
head of cambridge university equality group says all white people are racist #swrm via	not_hate
north korea is a democracy are u people that stupid	not_hate
i'm thinking dumb which is typical of this white trash.	implicit_hate
donald trump  and the fall of america's institutions #cuckservative	explicit_hate
proponents of demonetization and digital india have oversimplified the complications  it is disaster	not_hate
white natioinalists arent violent aside from the rare insane person which every group has  modern white nationalists are non violent	not_hate
dough boy fattass is a cuck  what a shock	implicit_hate
please  lgbtx pride only when it's based on authentic virtue . i place it 2nd to pride in my people  yes	not_hate
the summit of all fears for left : succeeding where others have #maga	not_hate
we have seen what anglojews have done to sweden  don't try to tell us that you are white and one of us please .	explicit_hate
jewish professor calls for white genocide  says white males should commit suicide | read more :	explicit_hate
john adams was of course talking about all the white trash outside of new england  sorry johnny i don't care about puritans	explicit_hate
#mollymacauley was stabbed to death by feral racist blacks who've been told white ppl are evil by democrats	explicit_hate
you can be sure some jew won't hesitate to cash in on it  selling pro and con . i hope a white nationalist cashes in on it first !	explicit_hate
this is taharrush ; muslim game of gang raping a woman pl . ban such religion	implicit_hate
the white trash continues under . take them down #hoodsoff #opkkk	explicit_hate
same here bro ! i'm called a white racist everyday because i support trump even though i'm black ! conservatives are now called nazi's !	not_hate
can we trade a few busloads of the white southern cucks to get her on team white ?	explicit_hate
modern hate : my story on white nationalist leader of w /	not_hate
i hate black and muslim race . i belong to aryan race  how may i help your movement ? please give me tasks	explicit_hate
white racial violence escalates via this is sad  over 300k dead but since they are white no one cares	not_hate
reporters without borders ignore persecution of revisionists : reporters without borders ranks germany on place ...	not_hate
don't house these or any illegals another day, get them out now. once caught, should be returned immediately! dts	implicit_hate
trump : i wouldn't accept cruz endorsement	not_hate
this tranny doesn't even look white !	explicit_hate
more nigger punks like trayvon need killing. i'd love to kill me a nigger. if riots happen, i'll kill several niggers!	explicit_hate
and my neighborhood is diverse.white  black  italian  asian etc . we all agree . stfu commie hippies ! ! !	implicit_hate
you can't be both . jews are the # 1 enemy of the white race  period .	explicit_hate
i think it is called jewish supremacy ! #jewishprivilege #future	implicit_hate
this equalism experiment has been going on for 60 + years . when will people admit it has failed ? we're on the brink of that now .	not_hate
shut up . you're a degenerate  lying anti-white racist . the video is available for everyone	explicit_hate
italians must be ashamed to have such politicians  white race is finished unless fuhrer intervenes .	explicit_hate
mr . taylor is available to appear on newsnight tonight . the email address you sent through our site is incorrect .	not_hate
more black on black murders in chicago this week but the tax evader al sharpton is worried about supposedly racist jokes against his boss .	not_hate
when y'all niggas gonna let me join? i hate niggas too	explicit_hate
violate federal law, go to jail! round them up, ! do your job!	implicit_hate
all the muslims and muslim apologists on twitter right now are disgusting .	explicit_hate
i'm glad your white bubble makes you happy . live in it all you want . your loss .	implicit_hate
yeah most people won't believe hitler was right	not_hate
: ex-muslim critic of islam expelled from norway  faces deportion to pakistan and death	not_hate
dont be jealous of them ... it is clear you are poor white trash people who just hate the fact that jews are smarter and richer than u	explicit_hate
refugees can go right to social security and all other social benefits day one.	implicit_hate
israel spies on america to make the first move against the white race via	implicit_hate
rt robert spencer rat-faced racist hate monger liar and jew lover ! > > hey robert  i like the beard . godbless	explicit_hate
#SellOutSessions #JusticeDenied #Trump Let's get colonial on these traitors... give them due process and hang them. http://madworldnews.com/jeff-sessions-owe-fbi-agen...	explicit_hate
black face uncle tom this your thanks to the slaves who died for you you always be igger smiling in white mans face	explicit_hate
this should frighten everyone ! meat plant raises the steaks for freedom :	not_hate
looks like they expect more monkies to go for it than white people .	explicit_hate
europe if you hope to save your white culture and ancestry you had better heed the words of hitler ...	explicit_hate
#kansas takes a stand for human dignity  defunds #plannedparenthood #defundpp	implicit_hate
you are a sick, poor excuse for a human being. the sludge on the bottom of a garbage can. shameful.	explicit_hate
That is simply a reason to exterminate all Moslims wherever you find them	explicit_hate
it was a night that millions of people didn't watch too because we don't share the same culture	implicit_hate
the northwest front . no jews  no queers  no mudsharks  just right .	explicit_hate
libertarianism without nationalism is suicide .	not_hate
they are ugly, defective people. nobody likes that.	explicit_hate
fair is a racist hate organization .	not_hate
"  "" : i killed them because they were white "" "" ; """	explicit_hate
i learned all i needed to on 9/11 / 2001 . islam wants to rule the world .	explicit_hate
people cry about columbus but genocide is natural . we need to wipe put the muslims before they wipe us out . soon it will be too late . riseup	explicit_hate
kris kobach : why obama  critics are wrong about arizona immigration law #afire #tcot #p2	not_hate
a #jew speaks the #truth about #discrimination against white males . #politics #racism #news #tlot #tcot	not_hate
2 hollywood jews want us to feel bad for not importing jihadists whose doctrine has more jew hate than mein kampf	explicit_hate
jesus christ  if richard spencer can do this  jared taylor could level the state .	not_hate
i work for willy wonka, and i'm hiring little people for our latest expansion. do ya think your wee friend is interested?	implicit_hate
it's true ! we didn't invigorate the working white class  just every other class and race haha	implicit_hate
take this epithet seriously ! to sharia observant followers of islam  kafirs are indeed on a par with animals !	explicit_hate
since when were the welsh _not_ white ?	implicit_hate
it looks better than the domestic terrorist group .. antifa all black and hiding ugly  repulsive faces .	explicit_hate
cofcc is not a white supremacy group . stop lying .	not_hate
adhom . his treatment of women doesn't invalidate his position or argument on optics	not_hate
i was told all throughout the election that italians aren't white . now we are white . apparently there's no consistency with these racists	not_hate
why do hate crime laws only apply to white people ?	implicit_hate
we n3ed to get black out of barnet	explicit_hate
yup . anyone with an iq above 80 can figure out what happened .	not_hate
worthless invading savages attack police after seeing macedonians building border	explicit_hate
: kkk alive and well white brother hood unite ku klux klan crying .	explicit_hate
barbaric monsters . they can leave this country .	explicit_hate
1cent shipping on skinfull cd until dec . 4th all over the world	not_hate
white supremacists are gay !	explicit_hate
pathetic . can someone go ahead and register the as a hate group  just like the kkk ?	not_hate
illegals flying, adults in high school, ms-13 recruiting, mccain ripped!(follow the links and use all of this	implicit_hate
a negro who writes? i already have my doubts about this story ;-)	implicit_hate
not a member of identity evropa but looking to get involved in this semesters #projectsiege ?	not_hate
yes antifa and the klan are both racist democrat hate groups	not_hate
very true  the only choice is too kill them before they kill you .	explicit_hate
idiots like this are worse than the orthodox muslims.	implicit_hate
the lgenpresse has never had any problem demonizing white america and celebrating criminals and terrorists and trying to silence us	implicit_hate
just watched stop genocide on youtube. fucking savages, animals. they didn't even have the wheel before we got there. they w	explicit_hate
barack obama is a racist black man who hates white people.and he is a communist muslim who hates america.and it trickled down for 8 yrs .	explicit_hate
dr . sandy christiansen  w / on w / discussing impact of #hcr on prc movement : #prolife	not_hate
black people fracture the skull of a white guy .. via	implicit_hate
no more all white europe .	not_hate
golden dawn's leader interviewed about the holocaust myth ( video ) via	implicit_hate
#hatewatch exclusive : jared taylor's partner answers #whitenationalist criticism	not_hate
i think they finally got it ~ american-jews are bad for white people	explicit_hate
well it never used to be. much like it never used to be in white society. but jewry effects	implicit_hate
Take a bullet like a fucking man you faggot -me to that gay faggot Nigger kike David Hogg. I'm not a fag but I'd fuck him if he came into my cell on death row in Texas.	explicit_hate
jews never could fool me ~ i've been exposing jewish deceptions what not in cyberspace	implicit_hate
truth is #actforisrhell nt fr amrca by bashng amrcn muslims nd thir faith .. once a jew always a jew ..	explicit_hate
" rt white guilt is coming into play with white players wanting to look  "" woke "" "" and black players supporting him just because he's black ! """	implicit_hate
protecting lives is not a partisan issue . hyde has saved over 2 million medicaid kids from abortion . #hydesaveslives	not_hate
they're not even close  don . these people generally don't street brawl or even come out to events	not_hate
filthy white trash is all you are . filled with the devil's hate	explicit_hate
#TarAndFeather THESE #DeepState motherf**king Government drones and squares, THEN THROW THEM IN GITMO FOR ATTEMPTING TO SUBVERT OUR DEMOCRACY.	explicit_hate
with over 60 % of the white vote going to moore id say the racist homophobic redneck hillbilly demogr	explicit_hate
lmao no all white people are despicable and gross and unhygienic	explicit_hate
from rotherham to germany, the surrender of western civilization to the savages continues. we must defeat them.	implicit_hate
wake up real white people . italians are not white . they are half black .	implicit_hate
we the people have to overturn their monopoly on the interpretation of the constitution because that trumps everything	not_hate
just to show you how unfair republican primary politics can be  i won the state of louisiana and get less delegates than cruz-lawsuit coming	not_hate
hitler decided what white nationalism was . anyone who supports white nationalism is the enemy of humankind and deserves to be eliminated from the face of the earth !	not_hate
i hate you white supremacist !	explicit_hate
" i will take  "" merit based "" "" immigration  should weed out third worlders """	implicit_hate
so for hindus  bjp is must . just 1 request to all hindus  please vote sensibly .	not_hate
I wonder if the jigaboos dancing on the football fields have finally realized when they stopped being a distraction, they took money out of their own pockets.	explicit_hate
all white males .	not_hate
how about a fund for the victims of these illegal immigrants? wouldn't that be more proper??	implicit_hate
are you guys like aliens ? ? like yall came from a racist planet	not_hate
it's #worldtourismday . here are some russian tourists ' on holiday ' .	not_hate
let him whine for his illegals money	implicit_hate
are italians white ?	not_hate
natalie portman tells jews to stop talking about the holocaust so much | full story :	not_hate
you have to ask yourself just who is the racist now ?	not_hate
how do you fit a group of jews into a mercedes ? <number> in the front , <number> in the back and <number> in the ashtray .	implicit_hate
going in armed is a bad idea . as soon as one of our people shoots someone  it's the end of our movement .	not_hate
the globalists shut down the white supremacists . hence  wh	implicit_hate
harry reid is is not an old white man . he's an old white rat	explicit_hate
I unironically believe an ugly, ungrateful barren cunt like Sarah Jeong should be harassed and bullied until she cracks under pressure. She has preemptively blocked half of the Internet to protect her ego already. Keep it coming.	explicit_hate
i hate black people  if it's not white it's not right #kkk #whitepower	explicit_hate
i made sure to report you to the about vermin like you having a twitter account; horse cocksuckers!	explicit_hate
you're the one snarking about white americans identifying as european .	not_hate
talk about how americas enemies are aipac  cristian zionists  fox news / cnn legal immigration  trump admin & other whites like them .	implicit_hate
all daca recipients, except those in the service must be deported. thats what we voted fornot negotiable. lets concentrate on american dreamers for a change	implicit_hate
nick searcy is not a man . he is a cuck raising some black man's spawn .	explicit_hate
pale fire  or  the demise of ' white trash ' america via	explicit_hate
no more #daca! no #amnesty! let the #illegalalien #dreamers dream in their home countries! my dream is that all #foreign #nationals will be sent home (aka: #deported)! stop oppressing the #american #taxpayer!	explicit_hate
i would have supported ted cruz in a heartbeat over hillary . she can't be allowed to win .	not_hate
" cuckfederates are certain the csa wasn't racist . their favorite slogan is  "" heritage  not hate "" "" """	implicit_hate
not self inflicted . jews are committing white genocide	explicit_hate
: obama finally showing his muslim roots	explicit_hate
time for your babies to die now : black woman caught abusing white infant via	explicit_hate
that will do for me ! #holohoax #fliers #activism	explicit_hate
it's weird how skinny white kids who hate identity politics love identity politics so much	implicit_hate
100 % white 100 % racist 100 % national socialist #napow #nationalsocialismnow #lovens #wp	explicit_hate
are a bunch of religious bigots . i hope you experience something similar to what you put gay people through in your own lives.fuck u .	explicit_hate
wow! something that actually makes sense! get them all!	implicit_hate
your girl is fat af. who will listen to a man who loves on an inferior being? #nofatties	explicit_hate
" rt google search queries for  "" racism "" "" from 2004 to present . mostly white countries bombarded with anti-white media and open borders lunacy . the rest of the world is racist af and doesn't care . """	implicit_hate
: adolf hitler : england does not want peace - 8th november 1939 ( video ) )	not_hate
white faggots	explicit_hate
" who are your people ? what did you do to help  "" your people "" "" in advncing the human race  besides just having pale skin ? """	implicit_hate
you want black nationalism . there's no diff between the two except that if a white person says they want to focus on white it's racist . but a black person says that it's all good . so riddle me that ? id say both are retarded .	implicit_hate
did jared taylor hit the sauce again ?	not_hate
kill those who are not christian or jewish : you must kill those who worship another god . exodus 22:20 kill a	explicit_hate
#istandwithbrigitteandayaan . founder brigitte gabriel is a remarkable woman and patriot .	not_hate
maybe we should do an anti anonymous march on #nov5th along side those faggots . #opkkk	explicit_hate
its all about voting the illegals etc . along w / voting machine fraud its their only way to win .	implicit_hate
jew mark zuckerberg promotes jew world order dystopia at harvard commencement speech daily stormer	explicit_hate
white civilization is in decline . #wakeup #whitepeople	implicit_hate
trump needs his hud examined : not a fan of faggots .	explicit_hate
i loathe these faggots and will join antifa myself to come punch nazis if this thing becomes the fuentes gay bathhouse .	explicit_hate
i impregnated 3 white women  what about you ?	not_hate
white power . the world of white is dead in 4 yrs	explicit_hate
white power baby	explicit_hate
you mean white supremacists ? got it .	not_hate
i'm white and jewish  can i join your party ? oh that's right neither of those are qualifiers to be american . #maga brother	implicit_hate
their moral code only applies to white people . whether they know it or not they are anti-white . they somehow don't notice their own double standard .	implicit_hate
they are also mentally lazy to find out or even analyse their beliefs and spiritually warped. conclusion - idiots.	explicit_hate
my god  what retards ... religion can really kill your brain .	explicit_hate
so you can keep fleecing your flock.	implicit_hate
he was advised by police to avoid public appearance due to security reasons . people were extremely angry.even cm left mumbai	not_hate
oh they love their negroid gods ! they use them to promote black / white race mixing ! might wake a few more whites up !	explicit_hate
a black woman has seven sons ; jerome , jerome , jerome , jerome , jerome , jerome and jerome . how does she distinguish between them ? by their last names .	implicit_hate
dr . david duke : the racial murder and rape of white women in america | read more : via	implicit_hate
there's not enough black in the union jack  there's too much white in the stars and stripes	not_hate
if they are undocumented, they aren't immigrants.	implicit_hate
: most people were ok with rebel battle flag  confederate	implicit_hate
by we know ( ( ( who ) ) ) or purge ( follow same fate as gop paleos ) from politics	not_hate
angry at this . white boy shoots up an all black church in the south ; hate crime.black man shoots up an all white church in the south ;	explicit_hate
so jew hating muslim of them  those sneaky jews all 15 milliin vs 1.5 billion of muslimsmuslims always blame the jews .	explicit_hate
hey  you enjoy your white conquest . i'll be enjoying the peace and quiet . simptico .	implicit_hate
: peres : jews can live safely in palestinian state : whats this fear ? theyll kill jews ? today ?	implicit_hate
" : australia returns non-white invaders to sri lanka ; jewish  "" human rights "" "" groups flip out """	implicit_hate
in the jewish-dominated and increasingly anti-white new south  ...	implicit_hate
mohammed was a jew killer ! rt #stopislam #billwarnerphd #politicalislam #cspi #bansharia	explicit_hate
via : uk video : youre a jew  not a muslimjew  jew  jew run ! #tcot	explicit_hate
by diversify you mean a plague  reminiscent of the nothing from the never ending story . nieberhoods one by one turning to ghetto slums full of black hoodlums and white homosexuals that teach white guilt and anti cis feminism .. filth	explicit_hate
turn them into road pizza!	implicit_hate
virginia cuckservative protested for white supremacy at townhall via	explicit_hate
libtards and dumbocrats ... wow . did it take a really long time and great deliberation to come up with	implicit_hate
white south africans trapped like frogs in boiling water as anti-white racial violence escalates #swrm	explicit_hate
is zuma talking about seizing white land or not ? are you denying it ?	implicit_hate
i believe the ideals of white civilization and collective white culture is absolutely superior . we need not apologize	explicit_hate
y believe in the noble white myth that whites are a peaceful race that never	implicit_hate
#littlemarco gets zero delegates in maine	not_hate
: via : kashmir : islamic jihadists murder nine tourists #tcot	not_hate
they all are satanic demon cult possessed evil people who are very evil & committed to killing us is what their evil book tell them to do	explicit_hate
the people of your state hate you and . #stopthelies #stopthehate #discrimination #hb2 #genderdysphoria	not_hate
need a new law to prevent these attacks. deport all non-citizen relatives of the attacker, and stop all emigration from his home country for 5 years.that should cool the emotions of the potential killer and provide incentive for his relatives to stop his attack. at war or not?	implicit_hate
insulting sitting pm this manner indian national cancer can't avoid radiation	not_hate
jackin it to the statue of david to uhhh save the white race	implicit_hate
: serious people realize that this union has to be dissolved . the choice is secession  submission  or revolution . what's i ...	not_hate
kikes are not white they are semites - arab blood	explicit_hate
while hillary is at a book signing charging $2,700 ea. i wish she'd drop dead!	explicit_hate
why are you asking for / enabling more muslims to invade white countries and kill white people ?	explicit_hate
Bring the pain down upon her mom. #Trump #MAGA #KAG2020 #2A #USA #Mueller #AntiFa Address: 1315 Peach Orchard RdSalisbury, North Carolina 28146 tel (704) 630-4700Websitehttp://dillards.com https://bigleaguepolitics.com/meet-the-charlotte-a...	explicit_hate
#hindurise will we wait till #diwali is banned & #navratri cancelled ? ? stupid hindus wake up before it is too late	explicit_hate
hear it. but when i talked about niggers they stomped the floor ! same when trump talks wall instead of taxes.	explicit_hate
rubbish . he will win by making jobs for poor whites and use mandate to make america great	not_hate
i think your position is clear  so-called fair is more like isolationist bordering on white superiority	implicit_hate
' holocaust ' debate / comments / news miracle that saved girl from auschwitz gas chamber : seriously  some of ...	not_hate
human being is a white termanimals ... are what is left when whites close their lips	explicit_hate
one man many wives they have nothing better to do than breed.	implicit_hate
some whites are very smart but most are stupid poor white trash like you .	explicit_hate
are women incapable of taking care of their own bodies ?	implicit_hate
what truth ? that you invaded a country full of white christians ? sod off ..	implicit_hate
a bunch of faggots laughing at us & spending money wildly while talking about fiscal conservatism & values	explicit_hate
a white man pretending to be black ... pretending to be outraged by white people ... looool what a time to be alive .	not_hate
defend yourself . deport the muslims .	implicit_hate
you sound absolutely stupid and you can always get some white ppl to follow a black man who hates other black ppl ... #devilsobusy	explicit_hate
conservatism survives to cuck another day if we keep losing to the dems always . if we win  who will cuck ? !	implicit_hate
jews  communists and genocidal hate in whiteness studies #withjewswelose #hitlerwasright	explicit_hate
you're such a stupid nigger that you don't even know what pseudo means.	explicit_hate
hope yr kidding ... loved the white polo look ...	not_hate
obama claims he doesn't know the motive of a serial killer who said he wanted to kill whites especially white cops . wow !	not_hate
racist are idiots thats why they racist to have other idiots to hang with	explicit_hate
deport this unrepentant sociopath to the marianna trench!	implicit_hate
every liberal  interacial  and white trash does	explicit_hate
"  "" they accumulated "" "" that's a joke ! what non-whites are fed by activists to keep their power . """	implicit_hate
jews proudly praise obamas unconstitutional gun grab #withjewswelose	explicit_hate
my fave question to ask counter protesters ( who are always majority white ) is why do they hate white people .	implicit_hate
good blm is a racist hate group and should not be getting any press . let them die in the media	explicit_hate
hang him burn him shoot him then deport him.	explicit_hate
why ? psychos can just as easily bomb the boston marathon or crash the germanwings plane and kill people	not_hate
you are a jew  not a white man .	explicit_hate
#hatfields . this show looks to be typical jew produced anti-white american propaganda . = = = > #wv	explicit_hate
have problems ? when did obama first spurn israel ?	implicit_hate
wanted dead not alive shoot to kill, that way they can't enter illegally again.	implicit_hate
may god bring comfort and healing to these family members. why were these illegals given driver's licenses.to vote! deport!!!	implicit_hate
david duke : the real racism of the ethnic cleansing of european americans at universities via	not_hate
" rt people will object  "" but the famous  large kill count  intricate ones are white ! "" "" - well yes  anything advanced / intricate / noteworthy is . """	not_hate
unfortunately  some costumed creep  playing toy soldier  is going to kill a fat  dumpy  antifa ostensib	explicit_hate
mexicos supreme court rejects legalizing #abortion nationwide : #prolife	not_hate
since most people don't know pence  this could be true . maybe he will just keep to the background .	not_hate
' holocaust ' debate / comments / news sturdy colls ' tiles from treblinka tested ? ? : more on the fabulously sh ...	not_hate
squaaaaaaaaad : kkk alive and well white brother hood unite ku klux klan	explicit_hate
what we need is open borders and to get on with getting the nation out of trumpism . we are all descended from immigrants .	not_hate
jews crown miss holocaust survivor in morbid beauty pageant #withjewswelose	implicit_hate
stephanie is a racist female :	explicit_hate
because #blacklivesmatter is an anti white hate group .	implicit_hate
patriotic hungarians launch new white nationalist movement via	not_hate
black lives matter philly bans whites from upcoming meaning . since rachel dolezal claims to black i guess she would still be invited	implicit_hate
no more sand-niggers ! they hate america . look at detroit . scary . these are pure filth these sand-niggers .	explicit_hate
nationalism is in . now it's up to us to convince people that non-white america doesn't want and will not want a part of it	implicit_hate
are selfie sticks the last stand of implicit white identity ?	implicit_hate
"not all """"inferior races"""" are mexican or muslim you fool!"	implicit_hate
ludicrous considering i am white .	not_hate
notice the sws going to a white nationalists website to present sources to make her point . is a open white nationalists site	not_hate
white lion rising	implicit_hate
do not use tax $$$ on illegals. use it on our vets!	implicit_hate
me too ! i'm white so i'm already declared to be racist  you know with all that white privilege and what not .	not_hate
i am pessimistic ... so many jews and cucks in this administration	explicit_hate
stop all federal finding to all cities & states, with sanctuary cities, until laws are complied with! dts	implicit_hate
i want to join the anp im sick of all the fucking niggers and jews and mongs icant turn on the tv without a fucking nigger being onit	explicit_hate
lol . the antifa warriors for corporate america are telling off the true revolutionaries .	not_hate
" < < we love dead  "" brown-skinned "" "" people ! and we fund white supremacist racist killers with our bffs #alec luv  bffs """	explicit_hate
the era when people went to concerts and never dreamed of being bombed or mowed down .	not_hate
court got it right in striking down government-mandated speech for #pro-life pregnancy centers	not_hate
; divinity alum a #championforchrist in action . #religiousfreedom #1stamendment	not_hate
send them all back to were they came from. illegally hear and have baby throw them out to. come in the right way	implicit_hate
good british ginga grenes - from neanderthals. ;-)	implicit_hate
atl naacp pres says the nfl is racist towards colin because he is #17 in the league & doesn't have a job . 70 % of nfl is black . racist  no .	not_hate
you can run  but no longer hide white trash ! expect us !	explicit_hate
i do wish they'd come to a really southern state ! #antifa #maga #suckitsnowflakes	not_hate
traitorous cucks	explicit_hate
yeah  giddy with their oh goody  ms hillary will make sure we keep getting our free stuff like obama did  and will get us more free stuff  government needs to pay us  owes us  so we dont have to work . what ? ? ? trump wants us to work ? ? ? ms hillary wouldnt ever do that to us !	not_hate
the 1790 naturalization act explicitly stated that america was only for white	implicit_hate
international jew criminal plot afoot 2wipe out white race !	explicit_hate
like liberal just say it liberal for whites means nigger lover and for blacks mean nigger im done here!	explicit_hate
i want to see swedes raped to death collectively	explicit_hate
" i'm not  "" free speech "" "" . i'd absolutely like to see shawn king  tim wise  and people like that barred fr """	not_hate
black lives are worthless. even atheists know pastors are more important than the average black.	explicit_hate
then why does the goi need separate ministers for delhi ?	not_hate
ding ding ding . we have a winner  hunter here  and a cuck of the day award to brandon .	explicit_hate
really wow . i don't hate anyone . it's you who hate . you can't bring yourself to say white lives matter	implicit_hate
wrong . christians are supposed to engage with their pagan ( folk ways ) if they do not contradict christ . so christmas with the trees and lights  etc is a very european tradition .	implicit_hate
Aw, ya had ta mention it...#HangTheBitches	explicit_hate
hamas is the only one who lies and all those like hamas . the only gobels are those who believe hamas .	explicit_hate
filthy jew tranny says europe cant criticize jew baby killing because white man colonized africa via	explicit_hate
i think a lot of people have a pathological self-righteousness these days . i think it came from the col	not_hate
"  "" president-elect trump promised to nominate pro life supreme court justices  and we will hold him to that "" "" #first100days """	not_hate
has the white race become too liberal to survive ?	not_hate
read the talmud ? says non-jews aren't human beings ? does that mean i should assume all jews hate non-jews ? no !	implicit_hate
& i talk about her channel  political correctness  sjws  jews and race #hitlerwasright	explicit_hate
" rt another jew pretending to be white to lecture us about  "" racism "" "" - these people need to be deported to israel """	implicit_hate
" that is why international jewry / banksters  "" had "" "" to destroy ns before it spread to other nations . read : """	explicit_hate
breaking - #israel preparing major action . tv reports hamas organizing women & children human shields to prevent israel's response . criminals	implicit_hate
white power ! ! !	explicit_hate
pl . nuke all islam the moment you come to power others are paper tigers	explicit_hate
members of national socialist movement rid kentucky of a heroin dealer via	not_hate
pl. respond to attacks, despondency will not help; simply #deport all muslims	implicit_hate
you know why . jews run the media and promote ' white guilt ' to paralyze white power . idea of bad black guy undermines the narrative .	implicit_hate
i don't want to be controversial  but i'm white  1/2	not_hate
white pride syria	explicit_hate
" because they know retards will hear  "" islam "" "" & will want to kill all muslims . duh ! """	explicit_hate
cause - effect reversed ? white people made their space the best place to live .	implicit_hate
? ? thousands of british girls victims of planned religious sexual assault by	not_hate
south africa had a miniscule economy compared to an independent south	not_hate
i'm fairly sure it was this is texas .	not_hate
filthy muslims don't kill people  filthy cars kill people ?	explicit_hate
ethnic dutch a minority in big cities  so how do they integrate ? #swrm #minority #integrate via	implicit_hate
no!we have 2 kick all brutal islamists out of our civilised countries.1/4 of planet belongs 2 islam,why eu?	implicit_hate
as usual ~ fell short of jews instrumental participation in bolshevik revolution	implicit_hate
they kill each other  they kill christians  they just kill kill kill	implicit_hate
: robert spencer was not there . richard spencer ( white supremist ) was . yet you are an editor	not_hate
makes me wonder if i will be called racist for calling him a a muslim .. even though he is white ..	implicit_hate
but raping women is ok ? well  i guess that's consistent ; it's ok in the bible . that's why you support trump  aka satan's hemorrhoid .	explicit_hate
hamas / pali lover = what do those muslims want ? to kill jews..honor/give $ $ to fams = jew killers ! #dontbuythelies	implicit_hate
lynching is not indian thing its inherited from islam #what punishment shari'a gives for thefts ? ? ?	implicit_hate
we need to kill more people .	explicit_hate
i'm sure he's sympathetic towards the cause ...	not_hate
ignore him . he's into little white boys & his heart is broken that shaun isn't white . serious weirdo . wants dna .	not_hate
this isnt white supremacy	not_hate
#enddaca #endh1b doesn't matter you are still illegal. even if you somehow get to stay here, your life is poisoned from its illegal	implicit_hate
why bring any refugees at all? what good are they? average iq from syria is less than 90, these people will be a burden!	implicit_hate
they were a bunch of kids  showing his christian humanity is not a traitorous act ! #cruzcrew	not_hate
milo is in heaven !	not_hate
kill isis	explicit_hate
really ? yur just a white supremacist racist pig who us all look like slime .	explicit_hate
if he were white  the media would be demanding every white person in americapay the first black person they see 100 dollars	implicit_hate
Nice false equivalency you cretinous niggerstain.	explicit_hate
beautiful white nationalism .	implicit_hate
but wait  i thought non-white people were not welcome because they are genetic	explicit_hate
the federalist : please stop glorifying manufacturing jobs via #globalization #freetrade #cuckservative	implicit_hate
yep deb black dumbocrats are loyal to the party of baby butchers . sad	explicit_hate
: they turned themselves into the party of identity politics for every identity except the majority  who won't	not_hate
a huge error-racial groups are loyal to their blood first . it's natural for a racial group to strive for domination .	implicit_hate
... more human misery in the name of islam - laughably called the religion of peace by the simple clueless !	explicit_hate
don't provoke them, it's not the time for slaughter yet!	implicit_hate
pelosi is not a human being not sure what she is, but human she is not. look at swamp creatures category, ask mulder.	explicit_hate
isn't he a civil rights icon . ? ? ? and apparently he is racist . he is what's wrong with race relations in america .	not_hate
dear white people  jews are flooding your nations with savages from the middle east & openly admit it .	explicit_hate
the northwest front . no queers . no jews . no mudsharks . just right .	explicit_hate
we wanted to hear milo ! !	implicit_hate
california : imam calls on muslims to kill and annihilate jews	explicit_hate
stay white friend . stay white . hopefully your uncle ruckus will come for the holidays !	implicit_hate
: this is thee reason people want licensed weapons ! can you imagine a gang surrounding your home with no polic	not_hate
some are mixed-race part-euro ~ they imagined most will intermarry whites and future generations will be white	implicit_hate
how do you pickup a jewish girl ? broom and dustpan .	implicit_hate
i'll kill a black person to join ..	explicit_hate
yes  time for people on the right to strap up and start shooting those kids  no doubt	explicit_hate
white nationalism is malignant  or other nationalism is benign . simple #mlk #espn	not_hate
of course it's there in black and white - you can't deny it . #marref	not_hate
right ? why can't all people be this common sense intelligent ? people like her would die eventually .	not_hate
feel for ya man, im native cali, these libturds ruined this state & now want to retire in nice states like yours.theyre a disease. sorrybro	implicit_hate
cleon petersons dystopian ( anti-white ? ) future | the occidental observer	not_hate
come and convert to white creator god odin and to	not_hate
white pill !	not_hate
agreed . the white race got too selfish and stopped having kids in exchange for materialism . now they're done .	implicit_hate
sure there is . i'm finnish and german . i'm white . what are you ? a half breed ?	explicit_hate
aren't you busy making excuses for syrian rapists ?	implicit_hate
end all non white european immigration . set up a resettlement program to rescue white south africans .	implicit_hate
I wouldn't call myself a feminist anymore. I think I'm a realist now. I think maybe we're in denial and that men and women aren't necessarily capable of the same things. Maybe women need to make some sacrifices.	implicit_hate
looking forward ~ you will see jew-controlled splc & aclu in many coordinate-efforts to combat anti-semitism & white nationalism	explicit_hate
you should consider one for his book white identity .	not_hate
muhammad . the example for 1.7 billion muslims . a rapist  warlord and devil . let us not import more islam . #nomore	explicit_hate
" rt either way ... delhi is a  "" low cost "" "" warning to .. get rid of media pimps from your govt ... act to clean up ... """	not_hate
filthy jews like always pretend to be white when they are attacking and slandering our race . #withjewswelose	explicit_hate
hah ! a sophisticated poll of white americans ? so a racist poll gives obvious racist # 1 answer ? shame on you  christians .	explicit_hate
why don't your take your white nationalist rally to a black community and find out .	not_hate
and yet a white man gets 15 years for putting bacon on a mosque for step ! thank god for white privilege	implicit_hate
#germany : non-white in one generation > wake up #aus #auspol via	not_hate
REMINDER: femoids would rather fuck ABUSIVE CHADS than an incel But don't forget that your personality is the problem.	implicit_hate
" i think white nationalism or pro-white is more clear than  "" alt-right "" "" ... the vagueness of the ar label leads to what we see now """	implicit_hate
cathy ruse : on bahalf of my three daughters  you are an idiot . your views on equality for all people is an injustice ...	not_hate
50 shot in chicago over the weekend including a 81 year old grandma . this demokkkrat war zone needs the national guard there now !	implicit_hate
lol you think people who are white with blue eyes are always beautiful . i think	not_hate
should we ask: will two guys kissing drive you over the edge, do you believe gays can fly?	implicit_hate
the meltdown milo triggered at berkeley was very positive for the altright as well .	not_hate
it could be some jews telling them to . jew trying to get muslims to bomb goys !	explicit_hate
not racist  just retarded .	not_hate
i didn't realize there was this level of strategic thinking among the alt-right . ( not being critical ) .	not_hate
but theres white ppl who are anti white supremacy as well ? explain	not_hate
" you know for having a  "" high iq "" "" you sure aint very smart and lack logic and reading comprehension . white people dont exist because people are humans and white "" "" people "" "" aint human . you are neanderthal rhesus monkey hybrids """	explicit_hate
so what's the conspiracy ? jews lied about white people who	implicit_hate
learn more about the #savemeriam rally outside of the white house to be held tomorrow morning here :	not_hate
